%%%%%%%%%%%%
%          %
%    %%    %
%    %%    %
%    %%%%%%%
%          %
%%%%%%%    %
%    %%    %
%    %%    %
%    %%    %
%          %
%%%%%%%%%%%%
