%%%%%%%%%%%%
%          %
%    %%    %
%    %%   M%
%    %%%%%%%
%          %
%%%%%%%    %
%C   %%    %
%    %%    %
%    %%    %
%          %
%%%%%%%%%%%%
